1111111111111
1001000000001
1000P11111001
100011E000001
1111111111111
