111111
100001
1001
1PCCC1
1E0001
111111
